1111111111111
10010000000C1
1000011111011
1P001E0000111
1111111111111