1111111111111
1001M000000C1

1000011111001
1PJ011E000001
1111111111111