1111111
1P0M0E1
100C001
1111111